R 10 10
S Map/test
F 147,94,199
      1111111111111
111111111111111
100001E11111101
11111111111111111
