R 500 500
S Maps/test
F 147,94,199
C 46,178,108
      1111111111111
111111111111111
100001E11111101
11111111111111111
