      N1111111111111
11111111111111
100001111111101
11111111111111111
